12:12
0   0  17 0  0  0  0  0 0  61 17  0
0   0  17 17 69 17 0  0 0  17 0   0
0   17 69 0  17 0  0  0 0  0  17  96
0   0  0  0  0  0  0  0 0  0  0   0
0   17 17 17 0  0  0  0 0  17 0   0
0   0  0  0  0 104  0  0 0  0  0   0
17  17 17 0  17 0  0  0 0  0  0   17
17  0  17 0  17 0  0  0 0  0  17  96
0   84 0  6  0  0  17 0 0  0  17  0
0   0  0  0  0  0  17 0 0  17 0   0
0   0  62 0  0  0  17 0 17 0  0   17
17  0  0  17 0  0  17 0 0  0  17  17
