12:12
0  0  0  37 0  0  0   0  0  17 69 17
0  17 0  0  0  17 0   0  0  17 0  0 
69 0  96  0  0  0  0   0  0  0  0  0
17 0  0  17 0  0  69  17 0  0  0  17
0  0  0  0  0  0  0   36 0  0  0  96 
0  17 0  100  0  17 0   0  0  17 0  0 
0  0  0  0  0  0  96 0  0  0  0  53
0  0  0 17 0  0  0   17 0  0  0 17 
0  0  0  0  0  0  0   0  0  0  0  0 
0  17 54 0  0  17 0   0  0  17 0  0 
0  0  0  0  0  84 0   0  6  0  0  96
17 0  0  17 0  0  0   17 0  0  0  0 
