12:12 
0 0 0 82 17 0 0 0 0 84 0 0  
17 17 17 32 17 0 17 17 17 17 96 0  
0 0 0 0 17 35 17 18 19 17 0 0  
32 0 0 0 17 36 17 16 16 17 0 0  
0 0 96 0 17 69 17 0 0 17 0 0  
0 0 0 96 17 17 17 0 0 17 0 0  
0 96 0 0 0 0 0 0 0 17 0 0  
0 17 32 17 0 0 0 0 0 17 0 0  
0 17 17 17 0 0 0 0 0 17 96 0  
0 0 0 0 0 0 0 0 0 17 96 0  
34 17 17 17 0 17 17 17 17 17 37 0  
33 0 48 0 0 0 0 0 96 0 0 0  

