12:12
0 0  17 0  0  0  0  17 0  56  0  101
0   0  17 17 17 0  17 0  0  0  17   0
0   17 0  0  0  0  17 0  0  69 17   0
0   0  0  0  0  0  0  0  0  0  0    0
0   17 0  96  0  0  0  17 0  0  0    68
0   0  0  0  0  6  0  0  0  0  0    0
17  17 17 0  17 0  0  6  0  0  0   17
101 0  0  0  17 0  0  0  0  17  17 96
0  0  0  6  0  0  0  69 0  0  0   0
0   0  55  0  0  0  0  0  0  0  0   0
0   0  0  0  0  0  0  84 17 0  0   0
17  0  0  17 0  0  0  0  0  0  17  0
