12:12
0   0   17 17 96 0  0   0   0  0  37 0
0   0   0  17 17  69 36  17  0  17 17 41
16   16   16 0  0   17 0   17  0  0  17 17
16  50  16  0  0   0  0   87   0  0  17 0
16   96   16 97  0  17 0   0   84 4 17 17
0   96   0  0  0   0 0   0   0  0  17 1
17  0   17 0  17  17 0   0   84 0  17 17
0  96   0 36  0   17 0   0   0  0  0  17
0   0   0  0  0   0  0   0   0  84  17 0
17  17   16 16 16  16 16   16 16  32  17 0
0 0 0 0 0 0 0 0 0 0 0 0
0 0 49 16 0 16 0 0 0 0 0 0
