12:12
107 107 107 107 17 0  69 0  0  17 0   0  
107 107 107 17  0  0  0  0  17 0  18  0  
107 107 107 17  0  0  0  6  0  17 106 0  
107 107 107 17  0  0  0  0  0  0  32  17 
17  17  17  17  0  98 0  0  17 0  0   0
0   0   0   0   0  0  0  0  69 0  0   17  
17  17  0   17  6  0  0  0  0  96 17  0
8   0   17  0   17 0  0  0  0  0  17  0
0   0   0   6   0  0  17 0  0  0  17  0
0   0   0   0   0  0  17 0  0  17 0   0
17  17  0   63  0  0  17 0  17 0  0   17
17  0   0   17  0  0  17 0  0  0  17  17
