12:12
0  0  0  0  0  0  17  0  0  60  0  17
0  17 0  0  0  96 0   0  0  17 0  0 
17 69 0 0  0  17  0  0  0  0  0  0
0  0  0  17 0  0   0   17 17 0  0  17
17 0  0  17 96  0   0   0  0  0  69 0 
0  17 0  0  0  17  0   0  0  17 0  0 
0  0  0  0  0  0   103 17 0  0  0  0 
0  0  0  17 0  0   0   17 0  0  0  96 
0  17 0  6  0  17  0   84 0  0  0  0
0  17 0  0  0  17  0   0  17 17 0  0 
17 0  0  36 0  105 0   0  0  0  0  21
17 59  0  17 0  0   69  17 0  0  0  0	 
