12:12 
0 0 0 0 89 90 69 0 0 0 0 0 
16 16 16 0 16 0 16 16 16 16 96 0  
0 0 82 0 16 35 16 18 19 16 0 0  
32 0 0 0 16 36 16 17 17 16 0 0  
0 0 0 0 16 37 16 0 0 16 0 0  
0 0 69 0 16 16 16 0 0 16 0 0  
0 0 0 0 0 0 0 0 88 16 0 0  
0 17 32 17 0 0 0 0 0 16 0 0  
0 17 17 17 0 0 0 0 0 16 0 0  
0 0 0 0 0 0 0 0 0 16 96 0  
34 16 16 16 16 16 16 16 16 16 37 0  
33 0 48 0 0 0 0 0 96 0 0 0  

