12:12
0 0 0 17 0 0 0 0 0 57 0 0
0 17 0 0 0 0 17 0 0 0 17 0
0 17 0 0 102 0 0 0 17 0 17 17
0 17 0 17 0 0 0 0 17 0 17 17
0 0 0 0 0 0 17 0 0 0 17 69 
0 0 0 17 0 17 0 0 0 0 0 0 
0 0 96 0 0 0 0 0 17 0 17 17 
0 0 0 0 0 0 96 17 0 0 0 0
17 0 0 17 17 20 0 17 0 0 0 0 
17 0 0 0 0 0 0 17 0 6 17 0 
0 0 0 0 17 17 17 0 0 0 17 96
0 58 0 0 0 0 0 4 0 0 0 0
