12:12
0  0  0  0  17  96   0  0  0  0  17 17
17  17 17 0  17  17  0  0  0  0  0  69 
0   0  0  0  0   0   17 0  17 0  0  0 
17  51 0  99  0   17  0  0  0  0  0  0 
0   0  0  0  0   0   0  0  17 0  0  0 
0   0  17 0  17  0   17 0  0  0  96  0 
0   0  96  0  0   0   0  0  0  0  0  52
0   0  0  0  17  0   0  17 0  0  17  0 
17  0  0  0  0   0   0  0  0  17 0  0 
96 0  0  0  0   0   0  0  0  0  0  0 
0   0 0  0  0   0   0  0  0  0  0  0 
17  0  0  0  69  0   0  0  17 0  0  0 
