12:12
107 107 17 18  0  0  0 0  0  17 107 107  
107 107 17 17  17  17  17 17  0 17 107 107  
107 107 17 0  0  0  0 0  105  17 107 107  
107 107 17 98  17  17  17 17 17 17 107 107 
107 107 17 0  0  0  100 0 0 17 107 107
107 107 17   17  17  17  17 17  0 17 107 107  
107 107 17   0  0  0  0 106  0  17 107 107
107 107 17  0  17  17  17 17 17  17 107 107
107 107 17   0  0  101  0 0  0  17 107 107
107 107 17   17  17  17  17 17  0 17 107 107
107 107 17   63  0  0  0  0 0 17 107 107
107 107 17   17  17  17  17 17  17  17 107 107


