12:12
17  17  17  17  0  0  0  17  0  60  0  17
17  0 0  0  88 17 0   0  0  17 0  0 
17 0 0 17  0  17  17 17  17  17  17  17
17  0  0  17 0  17   17   17 17 0  0  17
17 0  0  17 88  0   0   0  0  0  0 0 
17  0 0  17  0  17  17   17  17  17 0  0 
17  0 0  17  0  17   17 0  0  0  0 0
0  0  0  0 0 17  17 0  0  0  96 0
0  17 17  17  0  17  69   17 0  0  0  0
0  88  17  0  0  17  0   88  17 17 0  0 
17 0  17  0 105  17 0   0  88  0  0  0
17 59  17  17 0  17   0  17 0  0  0  0	
