12:12
17  32  32  17 0  0  0  0  0  0  0  17 
17  96  96  17 0  0  0  0  17  0  0  17
17  69  96  17 0  0  0  0  17  0  0  17
17  96  96  17 101 101 101 101   17  0  0  17
17  32  32  17 0  0  0  0  17  0  0  17 
17  0  0  17 0  0  0  0  17  0  0  17
17  0  0  17 102 102 102 102   17  0  0  17
17  0  0  17 0  0  0  0  17  0  0  17
17  0  0  17 0  0  0  0  17  0  0  17 
17  0  0  17 0  0  0  0  17  0  86  17
17  0  0  17 0  0  0  0  17  0  0  17
17 58 0 0 0 0 0 0 17 0 57 17
