12:12
0 54 0 0 69 0 0 0 0 0 0 0  

0 0 0 0 0 0 0 0 0 0 0 0  

16 16 16 16 16 16 16 16 16 16 16 0  

0 90 0 0 0 0 0 96 96 96 96 0
 0 0 0 0 0 0 0 96 96 96 96 0 

0 16 16 16 16 16 16 16 16 16 16 16  

0 16 16 16 16 16 16 16 16 16 16 16 

0 96 96 96 96 0 0 0 0 0 0 90 
 0 96 96 96 96 0 0 0 0 0 0 0 
16 16 16 16 16 16 16 16 16 16 16 0  

0 16 16 0 90 0 0  96 96 96 96 0
 
0 16 53 0 0 0 0 96 96 96 96 0  

