12:12
0 50 0 0 0 96 17 0 0    0 17 84 

17 17 17 0 0 0 17 0 17 0 17 96 

0 0 0 0 0 0 17    0 17 0 17 0  

0 0 0 0 0 0 0 0    17 0 0 0 

0 16 16 16 0 16 16 16 17 17 17 17  

0 16 33 16 0 16 38 16 0 32 0 69  

0 0 0 0 0 0 0 0 0 32 0 0  

0 16 16 16 0 16 16 16 0 32 0 84 
 
0 16 37 16 0 16 36 16 0 17 17 17
 
0 0 0 0 0 0 0 0 0 17 96 0  

32 17 17 17 17 17 17 17 17 17 0 0 
 
0 0 49 0 0 0 0 0 96 0 0 0  

