12:12 

0 0 0 0 0 96 0 0 0 0 0 0  

16 16 16 16 16 0 16 16 16 16 96 0  

0 0 0 0 0 0 16 18 19 16 0 0  

0 0 0 0 0 0 16 17 17 16 0 0 
 
0 0 0 0 0 0 0 0 0 16 0 0  

0 17 36 17 0 17 35 17 0 16 0 0  

0 17 17 17 0 17 17 17 0 16 0 0  

0 0 0 0 0 0 0 0 0 16 0 0 
 
0 17 34 17 0 17 69 17 0 16 0 0 
 
0 17 17 17 0 17 17 17 0 16 96 0  

32 16 16 16 16 16 16 16 16 16 0 0 
 
0 69 48 0 0 0 0 0 96 0 16 62  

