12:12
0 51 0 0 69 0 0 0 0 0 0 0  

16 16 16 16 16 16 16 16 16 16 16 32  

0 0 0 0 0 0 0 0 0 0 0 0  

32 16 16 16 16 16 16 16 16 16 16 0 
 
0 0 0 0 0 0 0 0 0 0 0 16  

0 16 16 16 16 16 16 16 16 16 0 16  

16 17 17 17 89 17 17 17 0 0 0 0  

32 32 32 32 0 0 0 0 0 0 0 0 
 
32 32 32 0 0 0 0 0 0 0 0 0 
 
32 32 32 0 0 0 0 0 0 0 0 0  

32 16 16 16 16 16 16 16 16 16 16 16 
 
32 0 52 0 0 0 0 0 96 0 0 0  

