12:12
84   17  0 0  0  17  0  0 17  61 17  0
0   17  0 17 0 17 0  0 17  83 17   0
0   0  0 17 0 17 0  0 17  83 17   0
17   17  17 17 0 17 0  0 17  83 17   0
0   0  0 0 0 17 0  0 17  83 17   0
0   0  0 0 0 0 0  0 17  83 17   0
0  0 0 0  32 32  0  0 0  0  0   17
17  17  17 17  17 32  0  0 0  0  17  96
69   0 0  0  0  32  32 0 0  0  17  0
0   0  0  0  0  32  32 0 0  17 0   0
84   0  0 62  0  32  32 0 17 0  0   17
84  0  0  0 0  32  32 0 0  0  17  49
