12:12
17 55  87  0  130   130  130   130  130   130  130  69
17  0  17  17 17  17 17  17 17  17  17 0
17  0  17  0  32   0  17  0  32   0  17  0
17  0  17  0  17  0  17  0  17  0  17  99
17  0  17  0  17  0  17  0  17  0  17  100
17  0  17  0  17  0  17  0  17  0  17  101
17  0  17  0  17  0  17  0  17  0  17  0
17  0  17  0  17  0  17  0  17  0  17  0
17  0  17  0  17  0  17  0  17  0  17  0
17  0  17  0  17  69  17  0  17  0  17 0
17  0  17  0  17  0  17  0  17  0  32  0
17  0  32   0  17  0  32   0  17  17 56  17
