12:12
16 0 16 89 16 32 32 16 82 16 16 16 
84 0  0 0 0  36 32 0  0 0  0 84
16 0 16 0 16 34 36 16 0 16 16 16 
82 0  0 88 0  32 32 0  88 0  0 0 
16 0 16 84 16 32 36 16 0 16 0 16 
38 32 36 34 32 34 35 32 32 36 32 37
37 32 36 34 32 35 34 32 32 36 32 38
16 0 16 0 16 36 32 16 84 16 0 16 
0 0  0 88 0  32 32 0  88 0  0 82 
16 16 16 0 16 36 34 16 0 16 0 16 
84 0  0  0  0 32  36 0  0  0  0 84
16 16 16 82 16 32 32 16 89 16 0 16 

