12:12
16 0 0 16 0 16 0 16 0 16 0 16 
0 0  89 0 0 0  0 0  0 0  89 0 
0 16 0 16 0 16 0 16 0 16 0 16 
0 0  0 0  88 0 0 0  88 0  0 0 
0 16 0 16 0 16 0 16 0 16 0 16 
0 0  0 0  0 0  90 0  0 0  0 0 
0 16 0 16 0 16 0 16 0 16 0 16 
0 0  0 0  88 0  0 0 88 0  0 0 
0 16 0 16 0 16 0 16 0 16 0 16 
0 0  89 0 0 0  0 0  0 0  89 0 
0 16 0 16 0 16 0 16 0 16 0 16 
16 0  0 0  0 0  0 0  0 0  0 0 
